10
#################E#####################################################
#        #            ##
##### ######## ##### ###
##             ##### ###
######### ##############
#         ##############
# ######################
# ######################
S ######################
#########################################################################