5
########################
E        #            ##
##### ######## ##### ###
##             ##### ###
####################S###