21
#########################################
#   #   #                   #           #
# ### # # ############### ### ######### #
#   # # # #         #     #   #   #     #
### # # # # # ####### ##### ### # # #####
# # # #   # # #   #   #   #   # # # #   #
# # # ##### # # # # ### # ### # # # # # #
#   # #     # # # # #   #     # # # # # #
# ### ##### # # # # # ######### # # # # #
#   # #   # #   # # # #         # #   # #
### # # # ####### # # # ######### ##### #
E       # #   #   # # #     #   #     ###
# ####### # # # ### # ##### # # ### # # #
# #     #   # # #   # #   #   # #   # # #
### # # ##### # # ### # # ##### # ### # #
# # # #         # #     #     # #   # # #
# # # ### ##### # # ######### ##### ### #
# # #   # #   # #     #     #       #   #
# ##### # # # ######### ### ######### # #
#           #           #              #S
#########################################