5
########
E      S
## ## ##
## ## ##
########