41
##########################################################################E############################################################################
#             #               #           #       #         #         #     #   #   #           #     #       #     #   #         #           #       #
# ####### # # # ############# # ####### # # ##### # ##### # # ####### # ### # # # # # ######### # ### # ### ### ### # # # ####### # ######### # ##### #
#       # # # # #   #       #   #     # #   #     #     # # # #       #   # # # # # #     # #   # # #   # # #   #   # #   #     #     # #   # # # #   #
####### ### # # # # # ### ####### ### # ##### ####### ### # ### ######### # # # # # ##### # # ### # ##### # # ### ### ##### ######### # # # # # # # ###
#     #     # #   # #   # #   #     # #     # #   #   #   #   #   #   #   #   #   #       # #     #       #   # #   # #     #   #   #   # # # # # #   #
##### ####### ##### ### # # # # ##### ##### ### # # ### ##### ### # # # ################### ####### ##### ##### ### # ##### # # # # ##### # # # # ### #
#       #     #   #   # #   #   # #     # # #   #   #   #   #     # #   #       #               #   # #           #   #     # # # #       # # #   #   #
# ### ### ##### # ### # ##### ### # ### # # # ####### ### # ####### ##### ##### # ############# # ### # ############### ##### # # ######### # ### # ###
#   # #   #     #     # #   # #   # #     # #   #   #     #         #     #   #   #     #     #   #   #         #         #   # # #         #     #   #
# # ### ### ############# # # # # # ####### ### # # ################# ##### # ##### ##### ### ##### ########### # ####### # ### # # ######### ####### #
# #   # #         #   #   # #   # # #     # #   # #       #   #   #   #   # #     #     #   #   #   #         #   #     # # #   # #   #   #     #   # #
# ### # ######### # # # ### ##### # # ### # # ### ##### # # # # # # ### # # ##### # ### ### # ### # # # ##### ##### ### # # ### # ### # # ##### # # # #
# #   # #   #   # # #   #   #     #     # #   #   #   # # # #   # #     # #   # # # # #     #     #   # #   #       #   # #   #   #     #   # # # # # #
# # # # # # # # # # ####### ########### # ##### ### # ### # ##### ####### ### # # # # ################# # # ############# ### ############# # # # # # #
# # # #   # # #   # #     #           # #   #   # # #   #     # #       #   #   # # #   #           #   # #     #           # #     #   #   #   # # # #
### # ##### # ##### # ### ########### ### # # ### # ### ##### # # ######### ### # # # # # ####### ### ### ##### # ########### # ### # # # ### ##### # #
#   # # #   # #     # #   #         #   # # #   # #   #     #   # #         #   # # # #         #   # #   # #   # #         # #   #   # # #     #   # #
# ### # # ### ### ### # ### ####### ### ### ### # ### ##### ### # # ######### ### # # ############# # # ### # ### # ####### # ### ##### # ##### # # # #
# #     # #       #   # #   #     #   #   #     #   #   #     # # #   #   #     #   # #   #         # # #     #         #   #     # #   #     # # # # #
# # ##### # ####### ### ### # ### ### ### # ####### ### ##### ### ### # # ##### ##### ### # ##### ### # ### ########### # # ####### # ####### # # # # #
# # # #   #   #     #   #   # # #   #   # #           # #   #       #   #   # # #   #     # #   # #   #   # #   #     # # #         # #       #   # # #
# # # # ####### ##### ### ### # ### ### # ########### # # # # ############# # # # # ##### # # # ### ##### # # # # ### ### ######### # ####### ####### #
# #   #         #   # #   # #   # #   # #         #   #   # # #   #         #     #   #   # # #     #     #   # #   #     #     #   #       #         #
# ############### # # # ### ### # ### # ######### # ####### ### # # ##### ########### # ### # ####### ######### # # ####### ### ########### ### ##### #
# #               # # #   # #   #   #   #     #   # #     # #   #   #   # #       #   # #   # #     #       #   # #   #     # #         # #   # #   # #
# # ############### # # # # # ### # ##### ### ### # # # # # # ####### # # # # ### # ##### # # # ### # ##### # ### ### # ##### ####### # # ### ### # ###
# #   #       #   # # # # #   #   #       # #   # # # # # # #   #   # # # # #   # #       # # # #   # # #   # #   #   #   #       #   #   #   #   #   #
# ### # ##### ### # # ### # ##### ##### ### ### # # ### # # ### ### # # # ##### # ########### # # ### # # ### ##### ##### ####### # ##### # # # ##### #
#     # #   #   # #   #   #     #   #   #     # # # #   # #         # # #       # #         # # # #     # #       #       #     # # #   # # # #     # #
# ##### # # ### # ##### ####### # ### ### # ### # # # ############# # # ######### # ####### # # # ### ### # ##### ####### # ### # # # # ### ####### # #
#     #   #   # #       #   #   # #   #   # #   # # # #   #     #   # #       #   #     #     # #   # #   # #   #       #   #     #   #   #         # #
##### # ##### # ####### # # # ### # ### ### # ### # # # # # ### # ### ####### # ####### ##### # ### ### ##### # ####### ########### ##### ########### #
#     # #     # #     # # # # #   #   # #   # #   # # # # #   # #   # #       #         #   # # #       #     # #   #   #         #     #         #   #
# ####### ##### # ### # # # # # ##### # # ### # ### # # # ### # # ### ####### ########### # # # # ##### # ##### # # ### # ####### ####### ####### # # #
# #       #   #   # #   # #   # # #   # #   # # #     # #     # # #   #     #     #   #   # # # # #   # #   # #   #   # # #     #   #   # #   #   # # #
# ##### ### ####### ##### ##### # # ### ### # # ####### ####### ### # # ### ##### # # # ### ### ### # # ### # ####### # # # ### ### # # ### # # # # # #
# #   #   # #           # #       #   # # # # #         #   #       # # # #     #   #   #       #   # # #   #         #   # # #   #   #     #   # # # #
# # # ### # # ######### # ########### # # # # ########### # ########### # ##### ################# ### ### ### ############# # ### ################# # #
#   #     #           #               #   #               #             #                         #       #                 #                       # #
###########################S###########################################################################################################################