5
########
E     ##
## #####
## #####
##S#####