17
#####################################################################################################
#     # #   #           #       #       #     #               #     #         #         #       #   #
# ### # # # # ######### # ### # ### ### ### # # ####### ##### # ### # ####### # ####### # ##### # # #
# #   #   #   #   #     # #   # #   # #     # # #     #   #   # # #   #     #   #     # #     #   # #
# # ####### ##### # ##### # ### # ### ####### # # # ##### # ### # ##### # ####### ### # ##### ##### #
# #       #       #       #   #   #       #   #   # #     #   #   #   # #   #     # # #     # #   # #
# ####### ##### ########### # ##### ##### # ##### ### ####### ### ### # ### # ##### # ##### # # # # #
E       #   #   #   #     # # #     #   #   #     #   #   #   #   #   # # #         #     #   # # # #
# ##### ### # ### # # ### # # ##### # # ##### ##### ##### # ##### # ### # ########### ### ##### # # #
#     #     # # # #   #   # #     #   # #   #     # #   #       # #       #         #   #       # # #
##### ####### # # ##### ### ##### ##### # ####### # # # ####### # # ####### ####### ########### # # #
# #   #         # #     #       #   #   # #       #   #     #   # # #     # #     #     #     # # # #
# # ############# # ########### ### # ### # ########### ### # ### ### ### # # ### ##### # ### ### # #
# # #     #   #   # #       #   #   #   #     #       # #   #   #     #     #   #   #     #       # #
# # ### # # # # ### ##### # ##### ##### ####### ##### ### ##### ############### ### ############### #
#       #   #   #         #       #             #         #                     #                   #
#############################################################################S#######################