5
########################
E                     ##
############## #########
############## #########
##############S#########