50
##################################################
E                   #############     ############
################### ############# ### ############
##      ########### ############# ### ############
## #### ##                        ### ############
## #### ## ###### ################### ############
## #### ## ###### ################### ############
## #### ## ###### ####                ############
## #### ##     ## #### ###########################
## #### ######### #### ###########################
## #### ############## ######### #################
## #### ############## ######### #################
## #### ############## ######### #################
## ####                ######### #################
## ############################# #################
##                                            ####
############################################# ####
#############                     ########### ####
############# ######### ######### ########### ####
############# ######### #### #### ########### ####
############# ######### #### #### ########### ####
############# ######### #### #### ########### ####
############# ######### #### #### ########### ####
############# #########      #### ########### ####
############# ################### ########### ####
############# ################### ########### ####
############# ################### ########### ####
############# ################### ########### ####
##            ###################             ####
## ###############################################
## ###############################################
## ###############################################
## ###############################################
## ########################      #################
## ######################## #### #################
##                          #### #################
################################ #################
################################ #################
##     ######                                #####
## ### ###### ############################## #####
## ### ###### ######################## ##### #####
## ### ###### ######################## ##### #####
## ### ###### ########################       #####
## ###        ####################################
## ###############################################
## ###############################################
## ###############################################
## ###############################################
##                                               #
################################################S#