21
#####################
E*****#*************#
#####*#*###########*#
#*****#*  #*******#*#
#*#####*###*#####*#*#
#*****#***#***# #***#
#####*###*###*# #####
#   #***#*# #***#***#
# #####*#*# ###*#*#*#
#    ***#*  #  *#*#*#
#####*###*#####*#*#*#
#*****#***#   #*#*#*#
#*#####*##### #*#*#*#
#*#*****#      ***#*#
#*#*##### #########*#
#*#*# #   #   #*****#
#*#*# # ### ###*#####
#***#   #  *****#   #
##### ### #*####### #
#     #   #*********S
#####################
